State,Month,Year,Severity 1,Severity 2,Severity 3,Severity 4,Total
AL,8,2022,36,77,15,0,128
AL,9,2022,4,43,3,6,56
AR,11,2022,1,55,0,6,62
AZ,8,2022,11,198,7,7,223
AZ,9,2022,1,136,3,7,147
AZ,11,2022,5,159,6,11,181
AZ,12,2022,3,236,3,16,258
CA,1,2023,1,2080,48,85,2214
CA,8,2022,136,1834,82,70,2122
CA,9,2022,35,1740,45,94,1914
CA,10,2022,12,1062,11,39,1124
CA,11,2022,28,1607,39,156,1830
CA,12,2022,34,2197,64,212,2507
CO,8,2022,9,98,5,4,116
CO,9,2022,2,88,1,10,101
CO,12,2022,1,110,1,28,140
CT,8,2022,4,106,4,9,123
CT,11,2022,1,81,1,14,97
CT,12,2022,2,77,2,19,100
DC,8,2022,1,21,0,0,22
DE,11,2022,1,9,0,1,11
FL,8,2022,71,872,44,25,1012
FL,9,2022,17,899,14,28,958
FL,10,2022,3,640,8,14,665
FL,11,2022,5,917,13,31,966
FL,12,2022,5,1225,11,65,1306
GA,8,2022,28,131,14,1,174
GA,9,2022,5,123,3,2,133
GA,10,2022,2,103,0,6,111
GA,11,2022,5,108,2,7,122
GA,12,2022,3,267,4,43,317
IA,8,2022,2,13,0,1,16
IL,8,2022,25,132,21,3,181
IL,9,2022,10,125,6,7,148
IL,11,2022,1,99,1,16,117
IN,8,2022,8,58,5,5,76
IN,9,2022,1,55,4,5,65
KS,11,2022,1,27,1,1,30
KY,8,2022,8,9,5,1,23
KY,9,2022,3,2,2,0,7
LA,8,2022,17,132,13,2,164
LA,9,2022,2,143,3,6,154
LA,12,2022,1,181,3,16,201
MA,8,2022,5,18,11,0,34
MA,9,2022,1,10,2,1,14
MD,8,2022,3,160,4,8,175
MD,9,2022,3,119,3,4,129
MD,10,2022,1,92,1,12,106
MD,11,2022,1,130,4,14,149
MD,12,2022,2,211,6,31,250
MI,8,2022,14,140,11,7,172
MI,9,2022,2,129,2,10,143
MN,8,2022,4,128,5,8,145
MN,9,2022,4,144,1,10,159
MN,12,2022,5,388,14,68,475
MO,8,2022,7,70,8,6,91
MO,9,2022,1,78,4,4,87
MO,10,2022,1,55,0,8,64
MO,11,2022,2,84,0,11,97
MS,9,2022,1,15,0,0,16
MT,11,2022,2,114,2,23,141
MT,12,2022,2,150,4,29,185
NC,8,2022,38,322,27,11,398
NC,9,2022,16,284,5,20,325
NC,10,2022,2,166,0,8,176
NC,11,2022,8,263,2,19,292
NC,12,2022,3,367,6,32,408
NE,8,2022,1,9,0,0,10
NJ,8,2022,15,240,7,7,269
NJ,9,2022,8,214,4,11,237
NJ,10,2022,2,183,4,16,205
NJ,11,2022,1,98,1,22,122
NJ,12,2022,4,148,5,23,180
NM,8,2022,1,6,0,0,7
NM,10,2022,1,3,0,0,4
NV,8,2022,3,15,0,4,22
NV,9,2022,1,15,0,1,17
NV,12,2022,1,15,1,4,21
NY,8,2022,16,635,33,15,699
NY,9,2022,6,678,18,49,751
NY,10,2022,4,429,14,56,503
NY,11,2022,5,260,6,51,322
NY,12,2022,2,311,12,81,406
OH,8,2022,26,23,24,1,74
OH,9,2022,11,11,3,0,25
OH,11,2022,2,316,7,33,358
OH,12,2022,2,338,6,64,410
OK,8,2022,5,33,4,1,43
OK,9,2022,1,29,0,2,32
OR,8,2022,4,123,5,4,136
OR,9,2022,3,131,4,8,146
OR,11,2022,6,152,5,26,189
OR,12,2022,14,302,8,53,377
PA,8,2022,22,408,12,18,460
PA,9,2022,8,391,9,26,434
PA,10,2022,2,214,3,22,241
PA,11,2022,6,353,7,61,427
PA,12,2022,6,449,17,83,555
RI,8,2022,2,5,3,0,10
RI,9,2022,1,2,2,0,5
SC,1,2023,1,518,7,15,541
SC,8,2022,81,371,51,22,525
SC,9,2022,18,335,17,21,391
SC,10,2022,3,288,0,11,302
SC,11,2022,1,300,1,17,319
SC,12,2022,5,499,10,50,564
TN,8,2022,22,209,11,9,251
TN,9,2022,6,165,12,7,190
TN,10,2022,3,95,2,7,107
TN,11,2022,4,129,4,18,155
TN,12,2022,3,185,4,28,220
TX,8,2022,41,411,41,15,508
TX,9,2022,13,589,15,29,646
TX,10,2022,2,330,1,14,347
TX,11,2022,6,466,5,50,527
TX,12,2022,1,651,10,58,720
UT,8,2022,3,70,5,2,80
UT,9,2022,1,93,3,1,98
UT,11,2022,1,58,2,12,73
UT,12,2022,2,96,3,13,114
VA,8,2022,25,412,14,8,459
VA,9,2022,9,428,5,29,471
VA,10,2022,5,282,8,22,317
VA,11,2022,5,420,6,53,484
VA,12,2022,17,599,13,82,711
WA,8,2022,9,65,7,2,83
WA,9,2022,3,80,4,8,95
WA,10,2022,3,26,1,4,34
WA,11,2022,4,47,2,13,66
WA,12,2022,1,61,2,14,78
WI,8,2022,1,57,0,2,60
WV,8,2022,2,13,0,2,17
WV,9,2022,1,28,0,0,29
WV,11,2022,1,40,1,2,44
WY,11,2022,1,10,1,7,19
AL,1,2023,0,54,0,2,56
AL,10,2022,0,33,0,4,37
AL,11,2022,0,49,1,1,51
AL,12,2022,0,46,3,0,49
AR,1,2023,0,49,1,1,51
AR,8,2022,0,55,1,2,58
AR,9,2022,0,47,0,2,49
AR,10,2022,0,35,0,2,37
AR,12,2022,0,48,2,4,54
AZ,1,2023,0,219,2,4,225
AZ,10,2022,0,122,1,4,127
CO,1,2023,0,129,3,4,136
CO,10,2022,0,52,1,8,61
CO,11,2022,0,82,4,12,98
CT,1,2023,0,74,0,5,79
CT,9,2022,0,98,5,11,114
CT,10,2022,0,57,1,6,64
DC,1,2023,0,45,0,1,46
DC,9,2022,0,45,0,1,46
DC,10,2022,0,20,0,2,22
DC,11,2022,0,37,0,7,44
DC,12,2022,0,42,1,10,53
DE,1,2023,0,10,0,0,10
DE,8,2022,0,13,0,1,14
DE,9,2022,0,13,0,1,14
DE,10,2022,0,15,0,1,16
DE,12,2022,0,11,0,2,13
FL,1,2023,0,1214,19,13,1246
GA,1,2023,0,250,10,9,269
IA,1,2023,0,27,1,1,29
IA,9,2022,0,15,0,1,16
IA,10,2022,0,3,0,2,5
IA,11,2022,0,17,0,4,21
IA,12,2022,0,25,2,3,30
ID,1,2023,0,7,1,0,8
ID,8,2022,0,12,1,0,13
ID,9,2022,0,7,0,0,7
ID,10,2022,0,8,1,1,10
ID,11,2022,0,7,0,4,11
ID,12,2022,0,10,0,2,12
IL,1,2023,0,104,2,4,110
IL,10,2022,0,63,1,10,74
IL,12,2022,0,119,4,23,146
IN,1,2023,0,46,1,1,48
IN,10,2022,0,30,0,4,34
IN,11,2022,0,55,0,14,69
IN,12,2022,0,64,2,22,88
KS,1,2023,0,26,1,1,28
KS,8,2022,0,27,0,1,28
KS,9,2022,0,33,0,4,37
KS,10,2022,0,18,0,1,19
KS,12,2022,0,39,0,4,43
KY,1,2023,0,4,0,0,4
KY,10,2022,0,4,0,0,4
KY,11,2022,0,5,1,0,6
KY,12,2022,0,4,0,1,5
LA,1,2023,0,190,2,2,194
LA,10,2022,0,90,2,5,97
LA,11,2022,0,119,1,7,127
MA,1,2023,0,2,0,0,2
MA,10,2022,0,2,0,0,2
MA,11,2022,0,5,0,1,6
MA,12,2022,0,5,0,1,6
MD,1,2023,0,140,2,6,148
ME,8,2022,0,1,0,0,1
MI,1,2023,0,145,4,13,162
MI,10,2022,0,73,0,6,79
MI,11,2022,0,121,1,25,147
MI,12,2022,0,138,3,29,170
MN,1,2023,0,400,9,25,434
MN,10,2022,0,50,2,16,68
MN,11,2022,0,134,1,32,167
MO,1,2023,0,101,3,3,107
MO,12,2022,0,82,0,19,101
MS,1,2023,0,17,0,2,19
MS,8,2022,0,20,0,0,20
MS,10,2022,0,6,0,0,6
MS,11,2022,0,14,1,0,15
MS,12,2022,0,12,2,0,14
MT,1,2023,0,87,3,8,98
MT,8,2022,0,42,1,1,44
MT,9,2022,0,29,2,0,31
MT,10,2022,0,16,0,1,17
NC,1,2023,0,388,3,12,403
ND,1,2023,0,13,1,1,15
ND,8,2022,0,3,0,1,4
ND,9,2022,0,2,0,0,2
ND,10,2022,0,2,0,1,3
ND,11,2022,0,2,0,2,4
ND,12,2022,0,7,0,6,13
NE,1,2023,0,3,0,0,3
NE,9,2022,0,5,0,0,5
NE,10,2022,0,3,1,2,6
NE,11,2022,0,7,1,1,9
NE,12,2022,0,6,0,0,6
NH,8,2022,0,1,0,0,1
NJ,1,2023,0,100,2,9,111
NM,1,2023,0,3,0,1,4
NM,9,2022,0,3,0,0,3
NM,11,2022,0,4,0,0,4
NM,12,2022,0,3,0,3,6
NV,1,2023,0,30,3,1,34
NV,10,2022,0,7,0,0,7
NV,11,2022,0,20,0,2,22
NY,1,2023,0,318,7,15,340
OH,1,2023,0,320,2,16,338
OH,10,2022,0,67,0,9,76
OK,1,2023,0,36,0,0,36
OK,10,2022,0,22,0,2,24
OK,11,2022,0,23,0,0,23
OK,12,2022,0,44,0,3,47
OR,1,2023,0,156,6,3,165
OR,10,2022,0,80,0,2,82
PA,1,2023,0,337,6,24,367
RI,1,2023,0,1,0,0,1
RI,10,2022,0,1,0,0,1
RI,11,2022,0,1,0,2,3
RI,12,2022,0,5,1,2,8
TN,1,2023,0,137,1,4,142
TX,1,2023,0,534,8,22,564
UT,1,2023,0,97,1,4,102
UT,10,2022,0,33,0,4,37
VA,1,2023,0,536,6,16,558
WA,1,2023,0,63,0,2,65
WI,1,2023,0,62,1,2,65
WI,9,2022,0,57,2,2,61
WI,10,2022,0,27,0,6,33
WI,11,2022,0,43,0,10,53
WI,12,2022,0,67,0,12,79
WV,1,2023,0,25,1,3,29
WV,10,2022,0,18,0,2,20
WV,12,2022,0,38,1,1,40
WY,1,2023,0,22,3,0,25
WY,8,2022,0,6,0,1,7
WY,9,2022,0,3,0,0,3
WY,10,2022,0,2,0,0,2
WY,12,2022,0,7,0,13,20
ME,9,2022,0,0,1,0,1
SD,8,2022,0,0,1,0,1
